{
    "tilesetName": "Tilesets/mapTileset1",
    "mapCols": 20,
    "mapRows": 20,
    "tileCols": 4,
    "tileRows": 4,
    "tiles1": [
        1,1,1,1,1,1,1,1,1,1,1,1,1,1,1,1,1,1,1,1,
        1,1,1,1,1,1,1,1,1,1,1,1,1,1,1,1,1,1,1,1,
        1,1,1,1,1,1,1,1,1,1,1,1,1,1,1,1,1,1,1,1,
        1,1,1,1,1,1,1,1,1,1,1,1,1,1,1,1,1,1,1,1,
        1,1,1,1,1,1,1,1,1,1,1,1,1,1,1,1,1,1,1,1,
        1,1,1,1,1,1,1,1,1,1,1,1,1,1,1,1,1,1,1,1,
        1,1,1,1,1,1,1,1,1,1,1,1,1,1,1,1,1,1,1,1,
        1,1,1,1,1,1,1,1,1,1,1,1,1,1,1,1,1,1,1,1,
        1,1,1,1,1,1,1,1,1,1,1,1,1,1,1,1,1,1,1,1,
        1,1,1,1,1,1,1,1,1,1,1,1,1,1,1,1,1,1,1,1,
	    1,1,1,1,1,1,1,1,1,1,1,1,1,1,1,1,1,1,1,1,
        1,1,1,1,1,1,1,1,1,1,1,1,1,1,1,1,1,1,1,1,
        1,1,1,1,1,1,1,1,1,1,1,1,1,1,1,1,1,1,1,1,
        1,1,1,1,1,1,1,1,1,1,1,1,1,1,1,1,1,1,1,1,
        1,1,1,1,1,1,1,1,1,1,1,1,1,1,1,1,1,1,1,1,
        1,1,1,1,1,1,1,1,1,1,1,1,1,1,1,1,1,1,1,1,
        1,1,1,1,1,1,1,1,1,1,1,1,1,1,1,1,1,1,1,1,
        1,1,1,1,1,1,1,1,1,1,1,1,1,1,1,1,1,1,1,1,
        1,1,1,1,1,1,1,1,1,1,1,1,1,1,1,1,1,1,1,1,
        1,1,1,1,1,1,1,1,1,1,1,1,1,1,1,1,1,1,1,1],
    "tiles2": [
        9,4,4,4,4,4,4,4,4,4,4,4,8,4,4,4,4,4,4,10,
        3,0,0,0,0,0,0,0,0,0,0,0,3,0,0,0,0,0,0,3,
        3,0,0,0,0,0,0,0,0,0,0,0,3,0,0,0,0,0,0,3,
        3,0,0,9,4,4,8,4,4,4,0,0,5,4,0,0,4,4,4,6,
        3,0,0,3,0,0,3,0,0,0,0,0,3,0,0,0,0,0,0,3,
        3,0,0,3,0,0,3,0,0,0,0,0,3,0,0,0,0,0,0,3,
        3,0,0,3,0,0,0,0,0,3,0,0,0,0,0,0,0,0,0,3,
        3,0,0,3,0,0,0,0,0,3,0,0,0,0,0,0,0,0,0,3,
        3,0,0,12,4,4,4,0,0,0,0,0,0,0,0,0,0,0,0,3,
        3,0,0,0,0,0,0,0,0,0,0,0,0,0,0,0,0,0,0,3,
        3,0,0,0,0,0,0,0,0,0,0,0,0,0,0,0,0,0,0,3,
        3,0,0,0,0,0,0,0,0,0,0,0,0,0,0,0,0,0,0,3,
        3,0,0,0,0,0,0,0,0,0,0,0,0,0,0,0,0,0,0,3,
        3,0,0,0,0,0,0,0,0,0,0,0,0,0,0,0,0,0,0,3,
        3,0,0,0,0,0,0,0,0,0,0,0,0,0,0,0,0,0,0,3,
        3,0,0,0,0,0,0,0,0,0,0,0,0,0,0,0,0,0,0,3,
        3,0,0,0,0,0,0,0,0,0,0,0,0,0,0,0,0,0,0,3,
        3,0,0,0,0,0,0,0,0,0,0,0,0,0,0,0,0,0,0,3,
        3,0,0,0,0,0,0,0,0,0,0,0,0,0,0,0,0,0,0,3,
        12,4,4,4,4,4,4,4,4,4,4,4,4,4,4,4,4,4,4,11]   
}