{
    "tilesetName": "Tilesets/mapTileset1",
    "mapCols": 20,
    "mapRows": 20,
    "tileCols": 4,
    "tileRows": 4,
    "tiles1": [
        1,1,1,1,1,1,1,1,1,1,1,1,1,1,1,1,1,1,1,1,
        1,1,1,1,1,1,1,1,1,1,1,1,1,1,1,1,1,1,1,1,
        1,1,1,1,1,1,1,1,1,1,1,1,1,1,1,1,1,1,1,1,
        1,1,1,1,1,1,1,1,1,1,1,1,1,1,1,1,1,1,1,1,
        1,1,1,1,1,1,1,1,1,1,1,1,1,1,1,1,1,1,1,1,
        1,1,1,1,1,1,1,1,1,1,1,1,1,1,1,1,1,1,1,1,
        1,1,1,1,1,1,1,1,1,1,1,1,1,1,1,1,1,1,1,1,
        1,1,1,1,1,1,1,1,1,1,1,1,1,1,1,1,1,1,1,1,
        1,1,1,1,1,1,1,1,1,1,1,1,1,1,1,1,1,1,1,1,
        1,1,1,1,1,1,1,1,1,1,1,1,1,1,1,1,1,1,1,1,
	    1,1,1,1,1,1,1,1,1,1,1,1,1,1,1,1,1,1,1,1,
        1,1,1,1,1,1,1,1,1,1,1,1,1,1,1,1,1,1,1,1,
        1,1,1,1,1,1,1,1,1,1,1,1,1,1,1,1,1,1,1,1,
        1,1,1,1,1,1,1,1,1,1,1,1,1,1,1,1,1,1,1,1,
        1,1,1,1,1,1,1,1,1,1,1,1,1,1,1,1,1,1,1,1,
        1,1,1,1,1,1,1,1,1,1,1,1,1,1,1,1,1,1,1,1,
        1,1,1,1,1,1,1,1,1,1,1,1,1,1,1,1,1,1,1,1,
        1,1,1,1,1,1,1,1,1,1,1,1,1,1,1,1,1,1,1,1,
        1,1,1,1,1,1,1,1,1,1,1,1,1,1,1,1,1,1,1,1,
        1,1,1,1,1,1,1,1,1,1,1,1,1,1,1,1,1,1,1,1],
    "tiles2": [
        9,4,4,4,4,4,4,4,4,4,4,4,4,4,4,4,4,4,4,10,
        3,0,0,0,0,0,0,0,0,0,0,0,0,0,0,0,0,0,0,3,
        3,0,0,0,0,0,0,0,0,0,0,0,0,0,0,0,0,0,0,3,
        3,0,0,0,0,0,0,0,0,0,0,0,0,0,0,0,0,0,0,3,
        3,0,0,0,0,0,0,0,0,0,0,0,0,0,0,0,0,0,0,3,
        3,0,0,0,0,0,0,0,0,0,0,0,0,0,0,0,0,0,0,3,
        3,0,0,0,0,0,0,0,0,0,0,0,0,0,0,0,0,0,0,3,
        3,0,0,0,0,0,0,0,0,0,0,0,0,0,0,0,0,0,0,3,
        3,0,0,0,0,0,0,0,0,0,0,0,0,0,0,0,0,0,0,3,
        3,0,0,0,0,0,0,0,0,0,0,0,0,0,0,0,0,0,0,3,
        3,0,0,0,0,0,0,0,0,0,0,0,0,0,0,0,0,0,0,3,
        3,0,0,0,0,0,0,0,0,0,0,0,0,0,0,0,0,0,0,3,
        3,0,0,0,0,0,0,0,0,0,0,0,0,0,0,0,0,0,0,3,
        3,0,0,0,0,0,0,0,0,0,0,0,0,0,0,0,0,0,0,3,
        3,0,0,0,0,0,0,0,0,0,0,0,0,0,0,0,0,0,0,3,
        3,0,0,0,0,0,0,0,0,0,0,0,0,0,0,0,0,0,0,3,
        3,0,0,0,0,0,0,0,0,0,0,0,0,0,0,0,0,0,0,3,
        3,0,0,0,0,0,0,0,0,0,0,0,0,0,0,0,0,0,0,3,
        3,0,0,0,0,0,0,0,0,0,0,0,0,0,0,0,0,0,0,3,
        12,4,4,4,4,4,4,4,4,4,4,4,4,4,4,4,4,4,4,11]   
}
